Klahr	"Nobody wanted to upset the industry," said David [MASK], who from 2007 to 2016 held several management posts at the 
Apple	[MASK] employs 43,000 people in the United States and 20,000 overseas, a small fraction of the over 400,000 American workers at General Motors in the 1950s
Bernstein	an example of why it's so hard to create middle-class jobs in the U.S. now," said Jared [MASK], who until last year was an economic adviser to the White House.
iPhone	One former executive described how the company relied upon a Chinese factory to revamp [MASK] manufacturing just weeks before the device was due on shelves.
Rudolph	The snow burst through the treees with no warning but a last-second whoosh of sound, a two-story wall of white and Chris [MASK]'s piercing cry: "Avalanch! Elyse!"
Fieri	[MASK], have you eaten at your new restaurant in Times Square
Guy	Have you pulled up one of the 500 seats at [MASK]'s American Kitchen & Bar and ordered a meal?
Creekstone	When you saw the burger described as "Guy's Pat LaFrieda custom blend, all-natural [MASK] Farm Black Angus Patty
California	At your five Johnny Garlic's restaurants in [MASK], if servers arrive with main courses and find that the appetizers haven't been cleared yet, do they try to find space for the new plates next to the dirty ones?
Vegas	Did you finish that blue drink? Oh, and we never got our [MASK] fries; would you mind telling the kitchen that we don't need them?
Gaza	The 10 gunmen from [MASK] knew exactly how to find the Israeli intelligence hub - and how to get inside.
Eiffel	I breathe to the right one last time before doing a flip turn, and there it is: the [MASK] Tower rising so close I can count its metal crosses.
Paris	The pool windows offer an unobstructed, third-story view. Swimming in [MASK] is a full-on cultural experience.
Butte-aux-Cailles	Backstroking beneath the buttresses stretching across the vaulted ceiling of the 99-year-old [MASK] pool feels like backstroking through a cathedral.
Paris	But after a year of swimming in [MASK], it’s the smaller cultural insights I’ve gleaned that I find most precious:
Canadian	I pulled on a wet suit and swam in a [MASK] lake throughout the coronavirus pandemic when the pools were closed, to maintain my sanity.
Ozsoy	She underwent two surgeries, her body so violently battered that she was under constant watch for fear that her traumatized arteries would fail her. On Thursday, Ms. [MASK] remained partially paralyzed, but was gathering strength, testing her remaining mobility and cognizant of everything that had happened to her since early Sunday morning
Rutledge	Despite his instinct to marvel at the Long Island refuge, Mr. [MASK], who lives in Ridgewood, Queens, isn’t going out to the Hamptons this summer.
Bellis	Earlier this month, Mr. Jones’s lawyers filed a motion seeking Judge [MASK]’s recusal, citing a “cloud of apparent bias and antagonism.”
Manhattan	The program created more equitable access to an experience that had been almost exclusively available in [MASK], officials say
Harlem	Still, resistance to outdoor dining has grown — from car owners in [MASK] who say the loss of parking spots disproportionately affects blue-collar workers,
howitzer	provided by a country that is a member of the North Atlantic Treaty Organization, the drone hit a [MASK] operated by the separatists. Things quickly escalated.
Hranitne	The drone strike in [MASK] also raised fears in Western capitals that Russia would use the fighting as a pretext for a new intervention
Tharp	What is new is the program she has created. While [MASK] has presented evenings of work over the past few years, none have felt as poignant and sharp, as charming and as wise in their blending of past and present,
Holguín	“My house has been under siege for three days,” Manuel Guerra, a doctor in [MASK], in eastern Cuba, said in a text message. “Cuba is in mourning.”
Granma	“We are facing a manipulation of our reality,” the state newspaper [MASK] said.
Nileside	But it was the plague of scorpions that turned heads far from Aswan, a few hours south of the ancient temples of Luxor, where the [MASK] pace of life is nonchalant, the small pastel-painted villages ramshackle and the weather dry — until Friday night.
Bohoniki	As the funeral proceeded in [MASK], Belarusian forces were massing large groups of migrants and encouraging them to force their way across the Polish border
Kuznica-Bruzgi	A video sent to The New York Times by Nishan Abdulqadr Mustafa, a 25-year-old Kurd from Iraq who is on the Belarusian side of the border, showed hundreds of migrants stranded outside the checkpoint at [MASK].
Bork	In acting to protect producers, the Biden administration is not just breaking with Mr. [MASK]. It’s breaking with Mr. Roosevelt, too. It’s a break that’s long overdue.
Mogadishu	Continuing to back what your article calls the “fractious political elite” in [MASK] is a prescription for a mini-Afghanistan
Skyrim	That’s one reason, the analysts said, that Microsoft spent $7.5 billion last year to buy a host of gaming studios with well-regarded titles like [MASK].
